-1	0	0	2	1	0	2	2	0	2	3	0	-1	0	0	-1	0	0	-2	17	106	2	7	10	2	7	10	2	7	10	2	7	10	-1	0	0	-1	0	0	-1	0	0	-1	0	0	-1	0	0	-1	0	0	2	9	0	-1	0	0	1	5	6	-1	0	0	-1	0	0	-1	0	0	-1	0	0	-1	0	0	-1	0	0	-1	0	0	-1	0	0	-1	0	0	-1	0	0
2	0	1	2	1	1	2	2	1	2	3	1	2	4	1	-1	0	0	-2	17	-6	2	7	11	2	7	11	2	7	11	2	7	11	2	5	10	2	6	10	-1	0	0	-1	0	0	1	5	6	2	8	1	2	9	1	2	10	1	1	5	7	-1	0	0	-1	0	0	-1	0	0	-1	0	0	-1	0	0	-1	0	0	-1	0	0	-1	0	0	-1	0	0	-1	0	0
2	0	2	2	1	2	2	2	2	2	3	2	2	4	2	-1	0	0	-2	17	-6	2	7	12	2	7	12	2	7	12	2	7	12	2	5	11	2	6	11	-1	0	0	-1	0	0	1	5	7	2	8	2	2	9	2	2	10	2	-1	0	0	-1	0	0	-1	0	0	-1	0	0	-1	0	0	-1	0	0	-1	0	0	-1	0	0	-1	0	0	-1	0	0	-1	0	0
2	0	3	2	1	3	2	2	3	2	3	3	2	4	3	-1	0	0	-2	17	-6	-1	0	0	3	6	3	-1	0	0	-1	0	0	2	14	2	2	15	2	-1	0	0	-1	0	0	-1	0	0	2	8	3	2	9	3	2	10	3	-1	0	0	-1	0	0	-1	0	0	-1	0	0	-1	0	0	-1	0	0	-1	0	0	-1	0	0	-1	0	0	-1	0	0	-1	0	0
2	0	4	2	1	4	2	2	4	2	3	4	2	4	4	-1	0	0	-2	17	-6	-1	0	0	3	6	4	-1	0	0	-1	0	0	2	14	5	2	15	5	-1	0	0	-1	0	0	-1	0	0	2	8	4	2	9	4	2	10	4	-1	0	0	-1	0	0	-1	0	0	-1	0	0	-1	0	0	-1	0	0	-1	0	0	2	1	10	2	2	10	2	3	10	-1	0	0
2	0	5	2	1	5	2	2	5	2	3	5	2	4	5	-1	0	0	-2	17	-6	-1	0	0	-1	0	0	-1	0	0	-1	0	0	-1	0	0	-1	0	0	-1	0	0	-1	0	0	-1	0	0	-1	0	0	-1	0	0	-1	0	0	-1	0	0	-1	0	0	-1	0	0	1	4	10	-1	0	0	-1	0	0	2	0	11	2	1	11	2	2	11	2	3	11	2	4	11
2	4	9	2	14	6	2	7	14	2	14	6	0	1	9	-1	0	0	-2	17	-6	-1	0	0	-1	0	0	-1	0	0	-1	0	0	-1	0	0	-1	0	0	-1	0	0	-1	0	0	-1	0	0	-1	0	0	-1	0	0	-1	0	0	-1	0	0	-1	0	0	-1	0	0	1	4	11	-1	0	0	-1	0	0	2	0	12	2	1	12	2	2	12	2	3	12	2	4	12
2	4	10	2	14	7	1	1	13	2	14	7	0	1	9	1	0	0	-2	17	-6	-1	0	0	-1	0	0	-1	0	0	-1	0	0	-1	0	0	-1	0	0	-1	0	0	-1	0	0	-1	0	0	2	12	0	-1	0	0	2	12	0	-1	0	0	-1	0	0	-1	0	0	1	4	12	-1	0	0	-1	0	0	2	0	13	2	1	13	2	2	13	2	3	13	2	4	13
1	7	15	1	7	15	1	1	14	1	7	14	1	6	14	-1	0	0	-2	17	-6	-1	0	0	-1	0	0	-1	0	0	2	11	10	-1	0	0	-1	0	0	-1	0	0	-1	0	0	-1	0	0	2	12	1	-1	0	0	2	12	1	-1	0	0	-1	0	0	-1	0	0	-1	0	0	-1	0	0	-1	0	0	2	0	14	2	1	14	2	2	14	2	3	14	2	4	14
-1	0	0	-1	0	0	-1	0	0	-1	0	0	-1	0	0	-1	0	0	-2	17	-2	-1	0	0	-1	0	0	-1	0	0	-1	0	0	-1	0	0	-1	0	0	-1	0	0	-1	0	0	-1	0	0	-1	0	0	-1	0	0	-1	0	0	-1	0	0	-1	0	0	-1	0	0	-1	0	0	-1	0	0	-1	0	0	2	0	15	-1	0	0	2	12	2	-1	0	0	2	4	15
-2	17	53	-2	17	-11	-2	17	-11	-2	17	-11	-2	17	-9	-1	0	0	2	11	10	-1	0	0	-1	0	0	1	12	4	1	13	4	1	14	4	1	15	4	-1	0	0	-1	0	0	-1	0	0	-1	0	0	-1	0	0	-1	0	0	-1	0	0	-1	0	0	-1	0	0	-1	0	0	-1	0	0	-1	0	0	-1	0	0	2	12	2	2	12	3	2	1	0	2	2	0
-1	0	0	-1	0	0	-1	0	0	-1	0	0	-1	0	0	-1	0	0	-1	0	0	-1	0	0	-1	0	0	1	12	5	1	13	5	1	14	5	1	15	5	-1	0	0	-1	0	0	-1	0	0	-1	0	0	-1	0	0	-1	0	0	-1	0	0	-1	0	0	-1	0	0	-1	0	0	-1	0	0	-1	0	0	-1	0	0	2	12	3	2	0	1	2	1	1	2	2	1
1	12	4	1	13	4	1	14	4	1	15	4	-1	0	0	-1	0	0	-1	0	0	-1	0	0	-1	0	0	1	12	6	1	13	6	1	14	6	1	15	6	-1	0	0	-1	0	0	-1	0	0	-1	0	0	1	8	12	-1	0	0	-1	0	0	-1	0	0	-1	0	0	-1	0	0	-1	0	0	-1	0	0	-1	0	0	-1	0	0	2	0	2	2	1	2	2	2	2
1	12	5	1	13	5	1	14	5	1	15	5	-1	0	0	-1	0	0	-1	0	0	-1	0	0	-1	0	0	1	8	5	1	9	5	1	10	5	1	11	5	-1	0	0	-1	0	0	-1	0	0	-1	0	0	1	8	13	-1	0	0	-1	0	0	-1	0	0	-1	0	0	1	4	10	-1	0	0	-1	0	0	-1	0	0	-1	0	0	2	0	3	2	1	3	2	2	3
1	12	6	1	13	6	1	14	6	1	15	6	-1	0	0	-1	0	0	-1	0	0	-1	0	0	-1	0	0	1	8	6	1	9	6	1	10	6	1	11	6	-1	0	0	-1	0	0	-1	0	0	-1	0	0	-1	0	0	-1	0	0	-1	0	0	-1	0	0	-1	0	0	1	4	11	-1	0	0	-1	0	0	-1	0	0	-1	0	0	2	0	4	2	1	4	2	2	4
1	8	8	1	9	8	1	10	8	1	11	8	-1	0	0	-1	0	0	-1	0	0	-1	0	0	-1	0	0	1	14	3	-1	0	0	1	13	2	1	13	2	-1	0	0	-1	0	0	-1	0	0	-1	0	0	-1	0	0	-1	0	0	-1	0	0	-1	0	0	-1	0	0	1	4	12	-1	0	0	-1	0	0	-1	0	0	1	3	0	2	0	5	2	1	5	2	14	6
1	8	9	1	9	9	1	10	9	1	11	9	-1	0	0	-1	0	0	1	0	5	-1	0	0	-1	0	0	1	12	4	1	13	4	1	14	4	1	15	4	1	12	4	1	13	4	1	14	4	1	15	4	-1	0	0	-1	0	0	-1	0	0	-1	0	0	-1	0	0	-1	0	0	-1	0	0	-1	0	0	-1	0	0	-1	0	0	-1	0	0	-1	0	0	2	14	7
-1	0	0	-1	0	0	-1	0	0	-1	0	0	-1	0	0	1	5	6	-1	0	0	-1	0	0	-1	0	0	1	12	5	1	13	5	1	14	5	1	15	5	1	12	5	1	13	5	1	14	5	1	15	5	-1	0	0	-1	0	0	-1	0	0	-1	0	0	-1	0	0	-1	0	0	-1	0	0	-1	0	0	-1	0	0	-1	0	0	-1	0	0	-1	0	0	2	14	6
-1	0	0	2	1	10	2	2	10	2	3	10	-1	0	0	1	5	7	-1	0	0	-1	0	0	-1	0	0	1	12	6	1	13	6	1	14	6	1	15	6	1	12	6	1	13	6	1	14	6	1	15	6	1	14	3	-1	0	0	-1	0	0	-1	0	0	-1	0	0	-1	0	0	-1	0	0	1	5	6	-1	0	0	-1	0	0	1	12	0	1	13	0	2	14	7
2	0	11	2	1	11	2	0	10	2	3	11	2	4	11	-1	0	0	-1	0	0	-1	0	0	-1	0	0	1	12	8	1	13	8	1	14	8	1	15	8	1	8	8	1	9	8	1	10	8	1	11	8	1	15	3	-1	0	0	-1	0	0	-1	0	0	-1	0	0	1	5	6	-1	0	0	1	5	7	-1	0	0	-1	0	0	1	12	1	1	13	1	1	14	1
2	0	12	2	1	12	2	2	12	2	3	12	2	4	12	-1	0	0	-1	0	0	-1	0	0	-1	0	0	1	12	9	1	13	9	1	14	9	1	15	9	1	8	9	1	9	9	1	10	9	1	11	9	1	15	3	-1	0	0	-1	0	0	-1	0	0	-1	0	0	1	5	7	-1	0	0	-1	0	0	-1	0	0	-1	0	0	-1	0	0	1	2	10	1	3	10
2	0	13	2	1	13	2	2	13	2	3	13	2	4	13	-1	0	0	-1	0	0	-1	0	0	-1	0	0	1	4	10	-1	0	0	-1	0	0	-1	0	0	-1	0	0	-1	0	0	-1	0	0	-1	0	0	-1	0	0	-1	0	0	-1	0	0	-1	0	0	-1	0	0	-1	0	0	-1	0	0	-1	0	0	-1	0	0	1	0	11	1	1	11	1	2	11	1	3	11
2	0	14	2	1	14	2	15	6	2	3	14	2	4	14	1	0	1	-1	0	0	-1	0	0	-1	0	0	1	4	11	-1	0	0	-1	0	0	-1	0	0	-1	0	0	-1	0	0	-1	0	0	-1	0	0	-1	0	0	-1	0	0	-1	0	0	-1	0	0	-1	0	0	-1	0	0	-1	0	0	-1	0	0	-1	0	0	1	0	12	1	1	12	1	2	12	1	3	12
2	0	15	-1	0	0	2	15	7	-1	0	0	2	4	15	1	2	13	-1	0	0	-1	0	0	-1	0	0	1	4	12	-1	0	0	-1	0	0	-1	0	0	-1	0	0	-1	0	0	-1	0	0	-1	0	0	-1	0	0	-1	0	0	-1	0	0	-1	0	0	-1	0	0	-1	0	0	-1	0	0	-1	0	0	-1	0	0	-1	0	0	-1	0	0	-1	0	0	1	15	0
2	14	2	2	15	2	2	3	9	2	14	2	2	15	2	1	2	14	-1	0	0	-1	0	0	-1	0	0	-1	0	0	-1	0	0	-1	0	0	-1	0	0	-1	0	0	-1	0	0	-1	0	0	-1	0	0	-1	0	0	-1	0	0	-1	0	0	-1	0	0	-1	0	0	-1	0	0	-1	0	0	-1	0	0	-1	0	0	-1	0	0	-1	0	0	1	13	3	1	15	1
2	14	4	2	15	4	2	3	9	2	14	4	2	15	4	-1	0	0	-1	0	0	-1	0	0	-1	0	0	-1	0	0	-1	0	0	-1	0	0	-1	0	0	-1	0	0	-1	0	0	-1	0	0	-1	0	0	-1	0	0	-1	0	0	-1	0	0	-1	0	0	-1	0	0	-1	0	0	-1	0	0	-1	0	0	-1	0	0	-1	0	0	-1	0	0	1	13	3	1	15	2
-1	0	0	1	10	11	1	12	11	1	12	10	-1	0	0	-1	0	0	-1	0	0	-1	0	0	-1	0	0	-1	0	0	2	1	0	2	2	0	2	3	0	-1	0	0	-1	0	0	-1	0	0	-1	0	0	-1	0	0	-1	0	0	-1	0	0	-1	0	0	-1	0	0	-1	0	0	-1	0	0	-1	0	0	-1	0	0	-1	0	0	-1	0	0	-1	0	0	-1	0	0
1	5	6	1	11	12	1	12	12	-1	0	0	-1	0	0	-1	0	0	-1	0	0	-1	0	0	-1	0	0	2	0	1	2	1	1	2	2	1	2	3	1	2	4	1	-1	0	0	-1	0	0	-1	0	0	-1	0	0	-1	0	0	-1	0	0	-1	0	0	-1	0	0	-1	0	0	-1	0	0	-1	0	0	-1	0	0	-1	0	0	-1	0	0	-1	0	0	-1	0	0
1	5	7	1	3	5	1	3	5	1	3	5	1	4	5	-1	0	0	-1	0	0	-1	0	0	-1	0	0	2	0	2	2	1	2	2	2	2	2	3	2	2	4	2	-1	0	0	-1	0	0	-1	0	0	-1	0	0	-1	0	0	-1	0	0	-1	0	0	-1	0	0	-1	0	0	-1	0	0	-1	0	0	-1	0	0	-1	0	0	-1	0	0	-1	0	0	-1	0	0
-1	0	0	-1	0	0	-1	0	0	-1	0	0	-1	0	0	-1	0	0	-1	0	0	1	6	11	-1	0	0	2	0	3	2	1	3	2	2	3	2	3	3	2	4	3	-1	0	0	-1	0	0	-1	0	0	-1	0	0	-1	0	0	-1	0	0	-1	0	0	-1	0	0	-1	0	0	-1	0	0	-1	0	0	-1	0	0	-1	0	0	-1	0	0	-1	0	0	-1	0	0
